#,#,*,#,#,#,#,#,#,#,#,#
#,#, , , , , , , , ,k0,#
#,#,D0,#,k0, , , , , , ,#
#,#,D0,#,#,#, ,#,#,#,#,#
#, , , , , , , , , , ,#
#, , , , , , , , , , ,#
#,#,#,#,#,@,#,#,#,#,#,#