#,#,*,#,#,#,#,#,#,#,#,#
#,#, ,#, , , , , , , ,#
#,#, ,#, , , , , , , ,#
#,#, ,#,#,#, ,#,#,#,#,#
#, , , , , , , , , , ,#
#, , , , , , , , , , ,#
#,#,#,#,#,@,#,#,#,#,#,#