#,#,*,#,#,#,#,#,#,#,#,#
#,#, ,#, , , ,k0, , , ,#
#,#, ,#, , , , , , , ,#
#,#,D0,#,#,#,u,#,#,#,#,#
#, , , , , , , , , , ,#
#, , , , , , , , , , ,#
#,#,#,#,#,@,#,#,#,#,#,#