#,#,*,#,#,#,#,#,#,#,#,#
#,#, ,#, , , ,k0, , , ,#
#,#, ,#, , , , , , , ,#
#,#,D0,#,#,#,D1,#,#,#,#,#
#, , , , , , , , , , ,#
#, , , , , , , , , ,k1,#
#,#,#,#,#,@,#,#,#,#,#,#