./HomeWork-Saprykin
# # * # # # # # # # # # 
# #   #       k0       # 
# #   #               # 
# # D0 # # # u # # # # # 
#                     # 
#                     # 
# # # # # @ # # # # # # 
no way to exit
