./HomeWork-Saprykin
# # * # # # # # # # # # 
# #   #               # 
# #   #               # 
# #   # # #   # # # # # 
#                     # 
#                     # 
# # # # # @ # # # # # # 
In FindPaths beginning: 6-5 0-2
DEBUG
6-5
5-5
5-4
5-3
5-2
4-2
3-2
2-2
1-2
0-2
