./HomeWork-Saprykin
# # * # # # # # # # # # 
# #                 k0 # 
# # D0 # k0             # 
# # D0 # # #   # # # # # 
#                     # 
#                     # 
# # # # # @ # # # # # # 
6-5
5-5
5-6
4-6
3-6
2-6
1-6
1-5
1-4
1-3
1-2
0-2
